AAA	Brassicales
AAB	Brassicales
AAD	Brassicales
AAC	Brassicales
AAG	Brassicales
AAF	Brassicales
AAE	Brassicales
AAH	Brassicales
AAI	Brassicales
AAJ	Brassicales
AAK	Brassicales
AAM	Brassicales
AAL	Brassicales
AAN	Brassicales
AAO	Brassicales
AAP	Brassicales
AAQ	Malvales
AAR	Malvales
AAS	Malvales
AAT	Malvales
AAU	Malvales
AAV	Malvales
AAW	Malvales
AAX	Malvales
AAZ	Sapindales
AAY	Sapindales
ABA	Sapindales
ABB	Sapindales
ABC	Sapindales
ABD	Sapindales
ABF	Sapindales
ABE	Sapindales
ABG	Sapindales
ABK	Sapindales
ABH	Sapindales
ABJ	Sapindales
ABI	Sapindales
ABM	Sapindales
ABN	Sapindales
ABL	Sapindales
ABO	Oxalidales
ABP	Oxalidales
ABQ	Oxalidales
ABR	Oxalidales
ABT	Oxalidales
ABS	Oxalidales
ABU	Huerteales
ABV	Malpighiales
ABW	Malpighiales
ABX	Malpighiales
ABZ	Malpighiales
ABY	Malpighiales
ACA	Malpighiales
ACB	Malpighiales
ACC	Malpighiales
ACD	Malpighiales
ACF	Malpighiales
ACE	Malpighiales
ACG	Malpighiales
ACH	Malpighiales
ACI	Malpighiales
ACJ	Malpighiales
ACL	Malpighiales
ACK	Malpighiales
ACM	Malpighiales
ACN	Malpighiales
ACO	Celastrales
ACP	Celastrales
ACR	Picramniales
ACQ	Picramniales
ACT	Rosales
ACS	Rosales
ACU	Rosales
ACV	Rosales
ACW	Rosales
ACX	Rosales
ACY	Rosales
ACZ	Rosales
ADA	Rosales
ADD	Rosales
ADH	Rosales
ADB	Rosales
ADE	Rosales
ADG	Rosales
ADC	Rosales
ADF	Rosales
ADJ	Rosales
ADI	Rosales
ADK	Rosales
ADM	Cucurbitales
ADL	Cucurbitales
ADN	Cucurbitales
ADO	Cucurbitales
ADQ	Cucurbitales
ADP	Cucurbitales
ADR	Cucurbitales
ADT	Fagales
ADS	Fagales
ADU	Fagales
ADW	Fagales
ADV	Fagales
ADX	Fagales
ADY	Fagales
ADZ	Fagales
AEA	Fagales
AEB	Fagales
AED	Fabales
AEC	Fabales
AEE	Fabales
AEG	Fabales
AEF	Fabales
AEH	Fabales
AEI	Fabales
AEK	Myrtales
AEJ	Myrtales
AEL	Myrtales
AEM	Myrtales
AEN	Myrtales
AEO	Myrtales
AEQ	Myrtales
AEP	Myrtales
AER	Myrtales
AES	Myrtales
AET	Myrtales
AEV	Zygophyllales
AEU	Zygophyllales
AEW	Geraniales
AEX	Geraniales
AEY	Geraniales
AFA	Geraniales
AEZ	Geraniales
AFC	Crossosomatales
AFB	Crossosomatales
AFD	Crossosomatales
AFF	Saxifragales
AFE	Saxifragales
AFG	Saxifragales
AFH	Saxifragales
AFI	Saxifragales
AFK	Saxifragales
AFJ	Saxifragales
AFL	Saxifragales
AFM	Saxifragales
AFN	Ericales
AFO	Saxifragales
AFP	Saxifragales
AFQ	Saxifragales
AFT	Vitales
AFS	Vitales
AFR	Vitales
AFU	Santalales
AFV	Santalales
AFW	Santalales
AFX	Santalales
AFY	Caryophyllales
AFZ	Caryophyllales
AGA	Caryophyllales
AGB	Caryophyllales
AGC	Caryophyllales
AGD	Caryophyllales
AGF	Caryophyllales
AGE	Caryophyllales
AGG	Caryophyllales
AGH	Caryophyllales
AGI	Caryophyllales
AGJ	Caryophyllales
AGK	Caryophyllales
AGM	Caryophyllales
AGL	Caryophyllales
AGN	Caryophyllales
AGQ	Lamiales
AGO	Lamiales
AGP	Lamiales
AGT	Lamiales
AGS	Lamiales
AGR	Lamiales
AGU	Lamiales
AGV	Lamiales
AGW	Lamiales
AGY	Lamiales
AGX	Lamiales
AHA	Lamiales
AGZ	Lamiales
AHB	Lamiales
AHC	Lamiales
AHD	Lamiales
AHE	Lamiales
AHF	Lamiales
AHG	Lamiales
AHI	Lamiales
AHK	Lamiales
AHH	Lamiales
AHJ	Lamiales
AHL	Lamiales
AHM	Lamiales
AHN	Lamiales
AHO	Lamiales
AHQ	Lamiales
AHP	Lamiales
AHS	Lamiales
AHR	Lamiales
AHT	Lamiales
AHU	Lamiales
AHV	Lamiales
AHW	Lamiales
AHX	Boraginales
AIA	Boraginales
AHY	Boraginales
AID	Boraginales
AHZ	Boraginales
AIB	Boraginales
AIC	Boraginales
AIE	Boraginales
AIF	Boraginales
AIG	Boraginales
AII	Gentianales
AIH	Gentianales
AIJ	Gentianales
AIL	Gentianales
AIK	Gentianales
AIM	Gentianales
AIN	Gentianales
AIO	Gentianales
AIQ	Solanales
AIP	Solanales
AIR	Solanales
AIS	Solanales
AIV	Solanales
AIW	Solanales
AIT	Solanales
AIU	Solanales
AIX	Solanales
AIY	Icacinales
AJB	Icacinales
AIZ	Icacinales
AJD	Icacinales
AJA	Metteniusales
AJC	Metteniusales
AJE	Aquifoliales-cladeA
AJG	Aquifoliales-cladeA
AJF	Aquifoliales
AJH	Aquifoliales-cladeA
AJI	Aquifoliales-cladeB
AJJ	Aquifoliales-cladeB
AJK	Garryales
AJL	Garryales
AJM	Garryales
AJN	Asterales
AJS	Asterales
AJP	Asterales
AJO	Asterales
AJQ	Asterales
AJR	Asterales
AJT	Asterales
AJV	Asterales
AJU	Asterales
AJW	Asterales
AJX	Asterales
AJY	Asterales
AJZ	Asterales
AKA	Asterales
AKC	Apiales
AKB	Apiales
AKE	Apiales
AKD	Apiales
AKF	Cornales
AKG	Apiales
AKH	Cornales
AKI	Apiales
AKJ	Dipsacales
AKK	Dipsacales
AKL	Dipsacales
AKN	Escalloniales
AKM	Escalloniales
AKO	Bruniales-cladeA
AKP	Bruniales-cladeB
AKQ	Paracryphiales
AKR	Ericales
AKS	Ericales
AKT	Ericales
AKU	Ericales
AKW	Ericales
AKV	Ericales
AKZ	Ericales
AKX	Ericales
AKY	Ericales
ALB	Ericales
ALA	Ericales
ALC	Ericales
ALD	Ericales
ALE	Ericales
ALF	Ericales
ALH	Ericales
ALG	Ericales
ALI	Ericales
ALJ	Ericales
ALL	Ericales
ALK	Ericales
ALN	Ericales
ALM	Ericales
ALQ	Ericales
ALO	Ericales
ALP	Ericales
ALR	Ericales
ALS	Ericales
ALT	Ericales
ALU	Ericales
ALW	Ericales
ALX	Ericales
ALV	Ericales
ALY	Cornales
ALZ	Cornales
AMA	Cornales
AMB	Cornales
AMD	Cornales
AMC	Cornales
AME	Berberidopsidales
AMF	Berberidopsidales
AMG	Berberidopsidales
AMI	Dilleniales
AMH	Dilleniales
AMJ	Gunnerales
AMK	Buxales
AML	Trochodendrales
AMM	Trochodendrales
AMN	Proteales
AMO	Proteales
AMR	Proteales
AMS	Proteales
AMQ	Proteales
AMP	Proteales
AMT	Proteales
AMU	Ranunculales
AMV	Ranunculales
AMW	Ranunculales
AMX	Ranunculales
AMZ	Ranunculales
AMY	Ranunculales
ANB	Ranunculales
ANA	Ranunculales
AND	Ranunculales
ANC	Ranunculales
ANF	Ranunculales
ANE	Ranunculales
ANG	Chloranthales
ANJ	Chloranthales
ANI	Chloranthales
ANH	Chloranthales
ANK	Acorales
ANM	Acorales
ANL	Acorales
ANO	Alismatales
ANN	Alismatales
ANQ	Alismatales
ANP	Alismatales
ANR	Alismatales
ANS	Pandanales
ANT	Pandanales
ANU	Liliales
ANV	Liliales
ANW	Liliales
ANZ	Asparagales
ANX	Asparagales
ANY	Asparagales
AOA	Asparagales
AOC	Asparagales
AOB	Asparagales
AOD	Asparagales
AOE	Asparagales
AOG	Arecales
AOF	Arecales
AOH	Arecales
AOI	Poales
AOJ	Poales
AOK	Poales
AOL	Poales
AON	Poales
AOM	Poales
AOO	Poales
AOP	Poales
AOQ	Poales
AOR	Poales
AOX	Poales
AOU	Poales
AOT	Poales
AOV	Poales
AOW	Poales
AOS	Poales
AOY	Commelinales
AOZ	Commelinales
APA	Zingiberales
APB	Zingiberales
APC	Zingiberales
APD	Zingiberales
APE	Zingiberales
APF	Dioscoreales-cladeA
APG	Dioscoreales-cladeB
APH	Piperales
APJ	Piperales
API	Piperales
APK	Piperales
APL	Piperales
APM	Piperales
APO	Laurales
APN	Laurales
APP	Laurales
APR	Magnoliales
APQ	Magnoliales
APS	Magnoliales
APU	Magnoliales
APT	Magnoliales
APV	Magnoliales
APX	Ceratophyllales
APW	Ceratophyllales
APY	Austrobaileyales
APZ	Austrobaileyales
AQA	Nymphaeales
AQC	Nymphaeales
NCO	Nymphaeales
AQB	Nymphaeales
AQD	Amborellales
ZQD	Amborellales
ATR	Amborellales
GIN	Ginkgoales
TPL	Cupressales
