AAA	Akaniaceae
AAB	Brassicaceae
AAD	Brassicaceae
AAC	Brassicaceae
AAG	Brassicaceae
AAF	Brassicaceae
AAE	Brassicaceae
AAH	Capparaceae
AAI	Capparaceae
AAJ	Caricaceae
AAK	Caricaceae
AAM	Cleomaceae
AAL	Cleomaceae
AAN	Moringaceae
AAO	Moringaceae
AAP	Resedaceae
AAQ	Bixaceae
AAR	Cistaceae
AAS	Dipterocarpaceae
AAT	Dipterocarpaceae
AAU	Malvaceae
AAV	Malvaceae
AAW	Thymelaeaceae
AAX	Thymelaeaceae
AAZ	Anacardiaceae
AAY	Anacardiaceae
ABA	Anacardiaceae
ABB	Burseraceae
ABC	Burseraceae
ABD	Kirkiaceae
ABF	Meliaceae
ABE	Meliaceae
ABG	Nitrariaceae
ABK	Rutaceae
ABH	Rutaceae
ABJ	Rutaceae
ABI	Rutaceae
ABM	Sapindaceae
ABN	Sapindaceae
ABL	Sapindaceae
ABO	Cunoniaceae
ABP	Cunoniaceae
ABQ	Cunoniaceae
ABR	Elaeocarpaceae
ABT	Oxalidaceae
ABS	Oxalidaceae
ABU	Tapisciaceae
ABV	Chrysobalanaceae
ABW	Clusiaceae
ABX	Dichapetalaceae
ABZ	Euphorbiaceae
ABY	Euphorbiaceae
ACA	Hypericaceae
ACB	Linaceae
ACC	Malpighiaceae
ACD	Malpighiaceae
ACF	Passifloraceae
ACE	Passifloraceae
ACG	Phyllanthaceae
ACH	Rafflesiaceae
ACI	Rhizophoraceae
ACJ	Rhizophoraceae
ACL	Salicaceae
ACK	Salicaceae
ACM	Salicaceae
ACN	Violaceae
ACO	Celastraceae
ACP	Celastraceae
ACR	Picramniaceae
ACQ	Picramniaceae
ACT	Cannabaceae
ACS	Cannabaceae
ACU	Elaeagnaceae
ACV	Elaeagnaceae
ACW	Elaeagnaceae
ACX	Moraceae
ACY	Moraceae
ACZ	Rhamnaceae
ADA	Rhamnaceae
ADD	Rosaceae
ADH	Rosaceae
ADB	Rosaceae
ADE	Rosaceae
ADG	Rosaceae
ADC	Rosaceae
ADF	Rosaceae
ADJ	Urticaceae
ADI	Urticaceae
ADK	Ulmaceae-A
ADM	Begoniaceae
ADL	Begoniaceae
ADN	Coriariaceae
ADO	Corynocarpaceae
ADQ	Cucurbitaceae
ADP	Cucurbitaceae
ADR	Tetramelaceae
ADT	Betulaceae
ADS	Betulaceae
ADU	Casuarinaceae
ADW	Fagaceae
ADV	Fagaceae
ADX	Juglandaceae
ADY	Juglandaceae
ADZ	Myricaceae
AEA	Myricaceae
AEB	Nothofagaceae
AED	Fabaceae
AEC	Fabaceae
AEE	Fabaceae
AEG	Fabaceae
AEF	Fabaceae
AEH	Polygalaceae
AEI	Quillajaceae
AEK	Combretaceae
AEJ	Combretaceae
AEL	Lythraceae
AEM	Lythraceae
AEN	Melastomataceae
AEO	Melastomataceae
AEQ	Myrtaceae
AEP	Myrtaceae
AER	Myrtaceae
AES	Onagraceae
AET	Penaeaceae
AEV	Zygophyllaceae
AEU	Zygophyllaceae
AEW	Melianthaceae
AEX	Melianthaceae
AEY	Vivianiaceae
AFA	Geraniaceae
AEZ	Geraniaceae
AFC	Staphyleaceae
AFB	Staphyleaceae
AFD	Stachyuraceae
AFF	Paeoniaceae
AFE	Paeoniaceae
AFG	Cercidiphyllaceae
AFH	Hamamelidaceae
AFI	Hamamelidaceae
AFK	Crassulaceae
AFJ	Crassulaceae
AFL	Saxifragaceae
AFM	Iteaceae
AFN	Cyrillaceae
AFO	Daphniphyllaceae
AFP	Grossulariaceae
AFQ	Grossulariaceae
AFT	Vitaceae
AFS	Vitaceae
AFR	Vitaceae
AFU	Balanophoraceae
AFV	Balanophoraceae
AFW	Loranthaceae
AFX	Santalaceae
AFY	Aizoaceae
AFZ	Amaranthaceae
AGA	Amaranthaceae
AGB	Amaranthaceae
AGC	Cactaceae
AGD	Cactaceae
AGF	Caryophyllaceae
AGE	Caryophyllaceae
AGG	Didiereaceae
AGH	Droseraceae
AGI	Nyctaginaceae
AGJ	Phytolaccaceae
AGK	Plumbaginaceae
AGM	Polygonaceae
AGL	Polygonaceae
AGN	Tamaricaceae
AGQ	Acanthaceae
AGO	Acanthaceae
AGP	Acanthaceae
AGT	Bignoniaceae
AGS	Bignoniaceae
AGR	Bignoniaceae
AGU	Byblidaceae
AGV	Calceolariaceae
AGW	Carlemanniaceae
AGY	Gesneriaceae
AGX	Gesneriaceae
AHA	Lamiaceae
AGZ	Lamiaceae
AHB	Lentibulariaceae
AHC	Lentibulariaceae
AHD	Linderniaceae
AHE	Martyniaceae
AHF	Phrymaceae
AHG	Phrymaceae
AHI	Oleaceae
AHK	Oleaceae
AHH	Oleaceae
AHJ	Oleaceae
AHL	Orobanchaceae
AHM	Orobanchaceae
AHN	Paulowniaceae
AHO	Pedaliaceae
AHQ	Plantaginaceae
AHP	Plantaginaceae
AHS	Scrophulariaceae
AHR	Scrophulariaceae
AHT	Stilbaceae
AHU	Tetrachondraceae
AHV	Verbenaceae
AHW	Verbenaceae
AHX	Boraginaceae
AIA	Boraginaceae
AHY	Codonaceae
AID	Codonaceae
AHZ	Coldeniaceae
AIB	Cordiaceae
AIC	Ehretiaceae
AIE	Hydrophyllaceae
AIF	Heliotropiaceae
AIG	Namaceae
AII	Apocynaceae
AIH	Apocynaceae
AIJ	Gelsemiaceae
AIL	Gentianaceae
AIK	Gentianaceae
AIM	Loganiaceae
AIN	Rubiaceae
AIO	Rubiaceae
AIQ	Convolvulaceae
AIP	Convolvulaceae
AIR	Hydroleaceae
AIS	Montiniaceae
AIV	Solanaceae
AIW	Solanaceae
AIT	Solanaceae
AIU	Solanaceae
AIX	Sphenocleaceae
AIY	Icacinaceae
AJB	Icacinaceae
AIZ	Icacinaceae
AJD	Icacinaceae
AJA	Icacinaceae
AJC	Icacinaceae
AJE	Aquifoliaceae
AJG	Aquifoliaceae
AJF	Aquifoliaceae
AJH	Helwingiaceae
AJI	Stemonuraceae
AJJ	Cardiopteridaceae
AJK	Eucommiaceae
AJL	Garryaceae
AJM	Garryaceae
AJN	Argophyllaceae
AJS	Asteraceae
AJP	Asteraceae
AJO	Asteraceae
AJQ	Asteraceae
AJR	Asteraceae
AJT	Calyceraceae
AJV	Campanulaceae
AJU	Campanulaceae
AJW	Goodeniaceae
AJX	Menyanthaceae
AJY	Menyanthaceae
AJZ	Rousseaceae
AKA	Stylidiaceae
AKC	Apiaceae
AKB	Apiaceae
AKE	Araliaceae
AKD	Araliaceae
AKF	Cornaceae
AKG	Cornaceae
AKH	Cornaceae
AKI	Pittosporaceae
AKJ	Adoxaceae
AKK	Caprifoliaceae
AKL	Caprifoliaceae
AKN	Escalloniaceae
AKM	Escalloniaceae
AKO	Bruniaceae
AKP	Columelliaceae
AKQ	Paracryphiaceae
AKR	Actinidiaceae
AKS	Actinidiaceae
AKT	Actinidiaceae
AKU	Balsaminaceae
AKW	Clethraceae
AKV	Clethraceae
AKZ	Ebenaceae
AKX	Ebenaceae
AKY	Ebenaceae
ALB	Ericaceae
ALA	Ericaceae
ALC	Fouquieriaceae
ALD	Fouquieriaceae
ALE	Lecythidaceae
ALF	Marcgraviaceae
ALH	Pentaphylacaceae
ALG	Pentaphylacaceae
ALI	Polemoniaceae
ALJ	Polemoniaceae
ALL	Primulaceae
ALK	Primulaceae
ALN	Roridulaceae
ALM	Roridulaceae
ALQ	Sapotaceae
ALO	Sapotaceae
ALP	Sapotaceae
ALR	Sarraceniaceae
ALS	Styracaceae
ALT	Styracaceae
ALU	Symplocaceae
ALW	Theaceae
ALX	Theaceae
ALV	Theaceae
ALY	Curtisiaceae
ALZ	Hydrangeaceae
AMA	Hydrangeaceae
AMB	Loasaceae
AMD	Nyssaceae
AMC	Nyssaceae
AME	Aextoxicaceae
AMF	Berberidopsidaceae
AMG	Berberidopsidaceae
AMI	Dilleniaceae
AMH	Dilleniaceae
AMJ	Gunneraceae
AMK	Buxaceae
AML	Trochodendraceae
AMM	Trochodendraceae
AMN	Nelumbonaceae
AMO	Platanaceae
AMR	Proteaceae
AMS	Proteaceae
AMQ	Proteaceae
AMP	Proteaceae
AMT	Sabiaceae
AMU	Eupteleaceae
AMV	Lardizabalaceae
AMW	Lardizabalaceae
AMX	Circaeasteraceae
AMZ	Menispermaceae
AMY	Menispermaceae
ANB	Berberidaceae
ANA	Berberidaceae
AND	Ranunculaceae
ANC	Ranunculaceae
ANF	Papaveraceae
ANE	Papaveraceae
ANG	Chloranthaceae
ANJ	Chloranthaceae
ANI	Chloranthaceae
ANH	Chloranthaceae
ANK	Acoraceae
ANM	Acoraceae
ANL	Acoraceae
ANO	Araceae
ANN	Araceae
ANQ	Alismataceae
ANP	Alismataceae
ANR	Potamogetonaceae
ANS	Pandanaceae
ANT	Pandanaceae
ANU	Melanthiaceae
ANV	Smilacaceae
ANW	Liliaceae
ANZ	Orchidaceae
ANX	Orchidaceae
ANY	Orchidaceae
AOA	Iridaceae
AOC	Amaryllidaceae
AOB	Amaryllidaceae
AOD	Asparagaceae
AOE	Asparagaceae
AOG	Arecaceae
AOF	Arecaceae
AOH	Arecaceae
AOI	Typhaceae
AOJ	Typhaceae
AOK	Bromeliaceae
AOL	Bromeliaceae
AON	Juncaceae
AOM	Juncaceae
AOO	Juncaceae
AOP	Cyperaceae
AOQ	Cyperaceae
AOR	Cyperaceae
AOX	Poaceae
AOU	Poaceae
AOT	Poaceae
AOV	Poaceae
AOW	Poaceae
AOS	Poaceae
AOY	Commelinaceae
AOZ	Pontederiaceae
APA	Musaceae
APB	Musaceae
APC	Cannaceae
APD	Marantaceae
APE	Zingiberaceae
APF	Dioscoreaceae-A
APG	Dioscoreaceae-B
APH	Aristolochiaceae
APJ	Aristolochiaceae
API	Aristolochiaceae
APK	Piperaceae
APL	Piperaceae
APM	Saururaceae
APO	Calycanthaceae
APN	Calycanthaceae
APP	Lauraceae
APR	Annonaceae
APQ	Annonaceae
APS	Magnoliaceae
APU	Magnoliaceae
APT	Magnoliaceae
APV	Myristicaceae
APX	Ceratophyllaceae
APW	Ceratophyllaceae
APY	Schisandraceae
APZ	Schisandraceae
AQA	Cabombaceae
AQC	Nymphaeaceae
NCO	Nymphaeaceae
AQB	Nymphaeaceae
AQD	Amborellaceae
ZQD	Amborellaceae
ATR	Amborellaceae
GIN	Ginkgoaceae
TPL	Cupressaceae 
