AAA	Eudicots
AAB	Eudicots
AAD	Eudicots
AAC	Eudicots
AAG	Eudicots
AAF	Eudicots
AAE	Eudicots
AAH	Eudicots
AAI	Eudicots
AAJ	Eudicots
AAK	Eudicots
AAM	Eudicots
AAL	Eudicots
AAN	Eudicots
AAO	Eudicots
AAP	Eudicots
AAQ	Eudicots
AAR	Eudicots
AAS	Eudicots
AAT	Eudicots
AAU	Eudicots
AAV	Eudicots
AAW	Eudicots
AAX	Eudicots
AAZ	Eudicots
AAY	Eudicots
ABA	Eudicots
ABB	Eudicots
ABC	Eudicots
ABD	Eudicots
ABF	Eudicots
ABE	Eudicots
ABG	Eudicots
ABK	Eudicots
ABH	Eudicots
ABJ	Eudicots
ABI	Eudicots
ABM	Eudicots
ABN	Eudicots
ABL	Eudicots
ABO	Eudicots
ABP	Eudicots
ABQ	Eudicots
ABR	Eudicots
ABT	Eudicots
ABS	Eudicots
ABU	Eudicots
ABV	Eudicots
ABW	Eudicots
ABX	Eudicots
ABZ	Eudicots
ABY	Eudicots
ACA	Eudicots
ACB	Eudicots
ACC	Eudicots
ACD	Eudicots
ACF	Eudicots
ACE	Eudicots
ACG	Eudicots
ACH	Eudicots
ACI	Eudicots
ACJ	Eudicots
ACL	Eudicots
ACK	Eudicots
ACM	Eudicots
ACN	Eudicots
ACO	Eudicots
ACP	Eudicots
ACR	Eudicots
ACQ	Eudicots
ACT	Eudicots
ACS	Eudicots
ACU	Eudicots
ACV	Eudicots
ACW	Eudicots
ACX	Eudicots
ACY	Eudicots
ACZ	Eudicots
ADA	Eudicots
ADD	Eudicots
ADH	Eudicots
ADB	Eudicots
ADE	Eudicots
ADG	Eudicots
ADC	Eudicots
ADF	Eudicots
ADJ	Eudicots
ADI	Eudicots
ADK	Eudicots
ADM	Eudicots
ADL	Eudicots
ADN	Eudicots
ADO	Eudicots
ADQ	Eudicots
ADP	Eudicots
ADR	Eudicots
ADT	Eudicots
ADS	Eudicots
ADU	Eudicots
ADW	Eudicots
ADV	Eudicots
ADX	Eudicots
ADY	Eudicots
ADZ	Eudicots
AEA	Eudicots
AEB	Eudicots
AED	Eudicots
AEC	Eudicots
AEE	Eudicots
AEG	Eudicots
AEF	Eudicots
AEH	Eudicots
AEI	Eudicots
AEK	Eudicots
AEJ	Eudicots
AEL	Eudicots
AEM	Eudicots
AEN	Eudicots
AEO	Eudicots
AEQ	Eudicots
AEP	Eudicots
AER	Eudicots
AES	Eudicots
AET	Eudicots
AEV	Eudicots
AEU	Eudicots
AEW	Eudicots
AEX	Eudicots
AEY	Eudicots
AFA	Eudicots
AEZ	Eudicots
AFC	Eudicots
AFB	Eudicots
AFD	Eudicots
AFF	Eudicots
AFE	Eudicots
AFG	Eudicots
AFH	Eudicots
AFI	Eudicots
AFK	Eudicots
AFJ	Eudicots
AFL	Eudicots
AFM	Eudicots
AFN	Eudicots
AFO	Eudicots
AFP	Eudicots
AFQ	Eudicots
AFT	Eudicots
AFS	Eudicots
AFR	Eudicots
AFU	Eudicots
AFV	Eudicots
AFW	Eudicots
AFX	Eudicots
AFY	Eudicots
AFZ	Eudicots
AGA	Eudicots
AGB	Eudicots
AGC	Eudicots
AGD	Eudicots
AGF	Eudicots
AGE	Eudicots
AGG	Eudicots
AGH	Eudicots
AGI	Eudicots
AGJ	Eudicots
AGK	Eudicots
AGM	Eudicots
AGL	Eudicots
AGN	Eudicots
AGQ	Eudicots
AGO	Eudicots
AGP	Eudicots
AGT	Eudicots
AGS	Eudicots
AGR	Eudicots
AGU	Eudicots
AGV	Eudicots
AGW	Eudicots
AGY	Eudicots
AGX	Eudicots
AHA	Eudicots
AGZ	Eudicots
AHB	Eudicots
AHC	Eudicots
AHD	Eudicots
AHE	Eudicots
AHF	Eudicots
AHG	Eudicots
AHI	Eudicots
AHK	Eudicots
AHH	Eudicots
AHJ	Eudicots
AHL	Eudicots
AHM	Eudicots
AHN	Eudicots
AHO	Eudicots
AHQ	Eudicots
AHP	Eudicots
AHS	Eudicots
AHR	Eudicots
AHT	Eudicots
AHU	Eudicots
AHV	Eudicots
AHW	Eudicots
AHX	Eudicots
AIA	Eudicots
AHY	Eudicots
AID	Eudicots
AHZ	Eudicots
AIB	Eudicots
AIC	Eudicots
AIE	Eudicots
AIF	Eudicots
AIG	Eudicots
AII	Eudicots
AIH	Eudicots
AIJ	Eudicots
AIL	Eudicots
AIK	Eudicots
AIM	Eudicots
AIN	Eudicots
AIO	Eudicots
AIQ	Eudicots
AIP	Eudicots
AIR	Eudicots
AIS	Eudicots
AIV	Eudicots
AIW	Eudicots
AIT	Eudicots
AIU	Eudicots
AIX	Eudicots
AIY	Eudicots
AJB	Eudicots
AIZ	Eudicots
AJD	Eudicots
AJA	Eudicots
AJC	Eudicots
AJE	Eudicots
AJG	Eudicots
AJF	Eudicots
AJH	Eudicots
AJI	Eudicots
AJJ	Eudicots
AJK	Eudicots
AJL	Eudicots
AJM	Eudicots
AJN	Eudicots
AJS	Eudicots
AJP	Eudicots
AJO	Eudicots
AJQ	Eudicots
AJR	Eudicots
AJT	Eudicots
AJV	Eudicots
AJU	Eudicots
AJW	Eudicots
AJX	Eudicots
AJY	Eudicots
AJZ	Eudicots
AKA	Eudicots
AKC	Eudicots
AKB	Eudicots
AKE	Eudicots
AKD	Eudicots
AKF	Eudicots
AKG	Eudicots
AKH	Eudicots
AKI	Eudicots
AKJ	Eudicots
AKK	Eudicots
AKL	Eudicots
AKN	Eudicots
AKM	Eudicots
AKO	Eudicots
AKP	Eudicots
AKQ	Eudicots
AKR	Eudicots
AKS	Eudicots
AKT	Eudicots
AKU	Eudicots
AKW	Eudicots
AKV	Eudicots
AKZ	Eudicots
AKX	Eudicots
AKY	Eudicots
ALB	Eudicots
ALA	Eudicots
ALC	Eudicots
ALD	Eudicots
ALE	Eudicots
ALF	Eudicots
ALH	Eudicots
ALG	Eudicots
ALI	Eudicots
ALJ	Eudicots
ALL	Eudicots
ALK	Eudicots
ALN	Eudicots
ALM	Eudicots
ALQ	Eudicots
ALO	Eudicots
ALP	Eudicots
ALR	Eudicots
ALS	Eudicots
ALT	Eudicots
ALU	Eudicots
ALW	Eudicots
ALX	Eudicots
ALV	Eudicots
ALY	Eudicots
ALZ	Eudicots
AMA	Eudicots
AMB	Eudicots
AMD	Eudicots
AMC	Eudicots
AME	Eudicots
AMF	Eudicots
AMG	Eudicots
AMI	Eudicots
AMH	Eudicots
AMJ	Basal_Eudicots
AMK	Basal_Eudicots
AML	Basal_Eudicots
AMM	Basal_Eudicots
AMN	Basal_Eudicots
AMO	Basal_Eudicots
AMR	Basal_Eudicots
AMS	Basal_Eudicots
AMQ	Basal_Eudicots
AMP	Basal_Eudicots
AMT	Basal_Eudicots
AMU	Basal_Eudicots
AMV	Basal_Eudicots
AMW	Basal_Eudicots
AMX	Basal_Eudicots
AMZ	Basal_Eudicots
AMY	Basal_Eudicots
ANB	Basal_Eudicots
ANA	Basal_Eudicots
AND	Basal_Eudicots
ANC	Basal_Eudicots
ANF	Basal_Eudicots
ANE	Basal_Eudicots
ANG	Chloranthales
ANJ	Chloranthales
ANI	Chloranthales
ANH	Chloranthales
ANK	Monocots
ANM	Monocots
ANL	Monocots
ANO	Monocots
ANN	Monocots
ANQ	Monocots
ANP	Monocots
ANR	Monocots
ANS	Monocots
ANT	Monocots
ANU	Monocots
ANV	Monocots
ANW	Monocots
ANZ	Monocots
ANX	Monocots
ANY	Monocots
AOA	Monocots
AOC	Monocots
AOB	Monocots
AOD	Monocots
AOE	Monocots
AOG	Monocots
AOF	Monocots
AOH	Monocots
AOI	Monocots
AOJ	Monocots
AOK	Monocots
AOL	Monocots
AON	Monocots
AOM	Monocots
AOO	Monocots
AOP	Monocots
AOQ	Monocots
AOR	Monocots
AOX	Monocots
AOU	Monocots
AOT	Monocots
AOV	Monocots
AOW	Monocots
AOS	Monocots
AOY	Monocots
AOZ	Monocots
APA	Monocots
APB	Monocots
APC	Monocots
APD	Monocots
APE	Monocots
APF	Monocots
APG	Monocots
APH	Magnoliids
APJ	Magnoliids
API	Magnoliids
APK	Magnoliids
APL	Magnoliids
APM	Magnoliids
APO	Magnoliids
APN	Magnoliids
APP	Magnoliids
APR	Magnoliids
APQ	Magnoliids
APS	Magnoliids
APU	Magnoliids
APT	Magnoliids
APV	Magnoliids
APX	Ceratophyllales
APW	Ceratophyllales
APY	Basal_Angiosperm
APZ	Basal_Angiosperm
AQA	Basal_Angiosperm
AQC	Basal_Angiosperm
NCO	Basal_Angiosperm
AQB	Basal_Angiosperm
AQD	Basal_Angiosperm
ZQD	Basal_Angiosperm
ATR	Basal_Angiosperm
GIN	Gymnosperms
TPL	Gymnosperms
