ALV	Camellia_lanceoleosa
AMS	Telopea_speciosissima
AOF	Phoenix_dactylifera
AOG	Elaeis_guineensis
APE	Zingiber_officinale
AAA	Bretschneidera_sinensis
AAB	Brassica_rapa
AAC	Arabidopsis_thaliana
AAD	Capsella_rubella
AAE	Aethionema_grandiflorum
AAF	Aethionema_arabicum
AAG	Arabidopsis_lyrata
AAH	Crateva_unilocularis
AAI	Capparis_pubiflora
AAJ	Carica_papaya
AAK	Jacaratia_spinosa
AAL	Cleome_serrulata
AAM	Cleome_gynandra
AAN	Moringa_oleifera
AAO	Moringa_stenopetala
AAP	Reseda_lutea
AAQ	Bixa_orellana
AAR	Helianthemum_apenninum
AAS	Vatica_mangachapoi
AAT	Hopea_chinensis
AAU	Theobroma_cacao
AAV	Gossypium_raimondii
AAW	Edgeworthia_tomentosa
AAX	Wikstroemia_canescens
AAY	Mangifera_indica
AAZ	Pistacia_vera
ABA	Anacardium_occidentale
ABB	Boswellia_sacra
ABC	Commiphora_habessinica
ABD	Kirkia_wilmsii
ABE	Toona_sinensis
ABF	Guarea_kunthiana
ABG	Peganum_harmala
ABH	Citrus_clementina
ABI	Zanthoxylum_bungeanum
ABJ	Pilocarpus_pennatifolius
ABK	Citrus_sinensis
ABL	Aesculus_assamica
ABM	Dipteronia_sinensis
ABN	Dipteronia_dyeriana
ABO	Callicoma_serratifolia
ABP	Eucryphia_cordifolia
ABQ	Caldcluvia_paniculosa
ABR	Elaeocarpus_glabripetalus
ABS	Averrhoa_carambola
ABT	Oxalis_corniculata
ABU	Tapiscia_sinensis
ABV	Chrysobalanus_icaco
ABW	Clusia_lanceolata
ABX	Dichapetalum_longipetalum
ABY	Manihot_esculenta
ABZ	Ricinus_communis
ACA	Hypericum_perforatum
ACB	Linum_usitatissimum
ACC	Bunchosia_armeniaca
ACD	Galphimia_gracilis
ACE	Passiflora_organensis
ACF	Passiflora_caerulea
ACG	Phyllanthus_virgatus
ACH	Rafflesia_cantleyi
ACI	Rhizophora_apiculata
ACJ	Carallia_brachiata
ACK	Populus_trichocarpa
ACL	Salix_brachista
ACM	Populus_deltoides
ACN	Viola_philippica
ACO	Euonymus_carnosus
ACP	Tripterygium_wilfordii
ACQ	Alvaradoa_amorphoides
ACR	Picramnia_pentandra
ACS	Cannabis_sativa
ACT	Humulus_scandens
ACU	Hippophae_rhamnoides
ACV	Elaeagnus_angustifolia
ACW	Elaeagnus_umbellata
ACX	Morus_alba
ACY	Ficus_racemosa
ACZ	Ziziphus_jujuba
ADA	Colletia_spinosissima
ADB	Fragaria_vesca
ADC	Pyrus_bretschneideri
ADD	Prunus_mume
ADE	Crataegus_cuneata
ADF	Prunus_persica
ADG	Gillenia_trifoliata
ADH	Malus_domestica
ADI	Urtica_fissa
ADJ	Elatostema_involucratum
ADK	Holoptelea_integrifolia
ADL	Begonia_peltatifolia
ADM	Begonia_leprosa
ADN	Coriaria_nepalensis
ADO	Corynocarpus_laevigatus
ADP	Cucumis_sativus
ADQ	Actinostemma_tenerum
ADR	Tetrameles_nudiflora
ADS	Corylus_sieboldiana
ADT	Corylus_avellana
ADU	Casuarina_cunninghamiana
ADV	Fagus_sylvatica
ADW	Quercus_glauca
ADX	Carya_illinoinensis
ADY	Juglans_regia
ADZ	Myrica_rubra
AEA	Comptonia_peregrina
AEB	Nothofagus_antarctica
AEC	Phaseolus_vulgaris
AED	Senna_bicapsularis
AEE	Medicago_truncatula
AEF	Caesalpinia_decapetala
AEG	Cercis_chinensis
AEH	Polygala_arillata
AEI	Quillaja_saponaria
AEJ	Combretum_indicum
AEK	Combretum_rotundifolium
AEL	Lagerstroemia_speciosa
AEM	Cuphea_hookeriana
AEN	Tibouchina_cardinalis
AEO	Melastoma_dodecandrum
AEP	Rhodomyrtus_tomentosa
AEQ	Eucalyptus_grandis
AER	Psidium_guajava
AES	Fuchsia_bracelinae
AET	Penaea_cneorum
AEU	Guaiacum_sanctum
AEV	Tribulus_terrestris
AEW	Greyia_sutherlandii
AEX	Melianthus_major
AEY	Balbisia_gracilis
AEZ	Pelargonium_hortorum
AFA	Geranium_maderense
AFB	Staphylea_bumalda
AFC	Euscaphis_japonica
AFD	Stachyurus_praecox
AFE	Paeonia_lactiflora
AFF	Paeonia_suffruticosa
AFG	Cercidiphyllum_japonicum
AFH	Hamamelis_virginiana
AFI	Distylium_buxifolium
AFJ	Bryophyllum_pinnatum
AFK	Crassula_ovata
AFL	Saxifraga_stolonifera
AFM	Itea_ilicifolia
AFN	Cyrilla_racemiflora
AFO	Daphniphyllum_himalayense
AFP	Ribes_burejense
AFQ	Ribes_fasciculatum
AFR	Vitis_vinifera
AFS	Leea_guineense
AFT	Cayratia_japonica
AFU	Balanophora_fungosa
AFV	Balanophora_harlandii
AFW	Loranthus_tanakae
AFX	Santalum_album
AFY	Delosperma_cooperi
AFZ	Chenopodium_quinoa
AGA	Amaranthus_hypochondriacus
AGB	Alternanthera_philoxeroides
AGC	Opuntia_dillenii
AGD	Hylocereus_undatus
AGE	Dianthus_caryophyllus
AGF	Stellaria_media
AGG	Alluaudia_procera
AGH	Dionaea_muscipula
AGI	Mirabilis_jalapa
AGJ	Phytolacca_americana
AGK	Limonium_aureum
AGL	Fagopyrum_tataricum
AGM	Polygonum_runcinatum
AGN	Tamarix_chinensis
AGO	Avicennia_marina
AGP	Thunbergia_alata
AGQ	Strobilanthes_cusia
AGR	Handroanthus_impetiginosus
AGS	Jacaranda_mimosifolia
AGT	Bignonia_capreolata
AGU	Byblis_gigantea
AGV	Jovellana_punctata
AGW	Silvianthus_bracteatus
AGX	Gesneria_pedicellaris
AGY	Dorcoceras_hygrometricum
AGZ	Lamium_album
AHA	Prostanthera_ovalifolia
AHB	Pinguicula_agnata
AHC	Genlisea_aurea
AHD	Lindernia_crustacea
AHE	Proboscidea_fragrans
AHF	Mimulus_guttatus
AHG	Lancea_tibetica
AHH	Olea_europaea
AHI	Fraxinus_quadrangulata
AHJ	Jasminum_nudiflorum
AHK	Forsythia_viridissima
AHL	Orobanche_aegyptiaca
AHM	Cymbaria_mongolica
AHN	Paulownia_fargesii
AHO	Sesamum_indicum
AHP	Digitalis_purpurea
AHQ	Antirrhinum_majus
AHR	Verbascum_thapsus
AHS	Buddleja_alternifolia
AHT	Bowkeria_verticillata
AHU	Polypremum_procumbens
AHV	Verbena_bonariensis
AHW	Phyla_scaberrima
AHX	Anchusa_officinalis
AHY	Codon_royenii
AHZ	Coldenia_procumbens
AIA	Bothriospermum_chinense
AIB	Varronia_sp.
AIC	Ehretia_dicksonii
AID	Codon_schenckii
AIE	Nemophila_menziesii
AIF	Heliotropium_arborescens
AIG	Eriodictyon_crassifolium
AIH	Vinca_major
AII	Catharanthus_roseus
AIJ	Gelsemium_rankinii
AIK	Swertia_bimaculata
AIL	Eustoma_grandiflorum
AIM	Strychnos_nux-vomica
AIN	Coffea_canephora
AIO	Neolamarckia_cadamba
AIP	Convolvulus_arvensis
AIQ	Ipomoea_purpurea
AIR	Hydrolea_spinosa
AIS	Montinia_caryophyllacea
AIT	Nicotiana_sylvestris
AIU	Lycium_barbarum
AIV	Solanum_lycopersicum
AIW	Schizanthus_pinnatus
AIX	Sphenoclea_zeylanica
AIY	Iodes_cirrhosa
AIZ	Natsiatopsis_thunbergiifolia
AJA	Pittosporopsis_kerrii
AJB	Merrilliodendron_megacarpum
AJC	Platea_latifolia
AJD	Pyrenacantha_malvifolia
AJE	Ilex_purpurea
AJF	Ilex_polyneura
AJG	Ilex_chinensis
AJH	Helwingia_japonica
AJI	Gomphandra_tetrandra
AJJ	Gonocaryum_calleryanum
AJK	Eucommia_ulmoides
AJL	Aucuba_japonica
AJM	Garrya_elliptica
AJN	Corokia_cotoneaster
AJO	Lactuca_sativa
AJP	Helianthus_tuberosus
AJQ	Mutisia_acuminata
AJR	Senecio_vulgaris
AJS	Dasyphyllum_diacanthoides
AJT	Calycera_herbacea
AJU	Lobelia_cardinalis
AJV	Campanula_cochleariifolia
AJW	Scaevola_aemula
AJX	Nymphoides_indica
AJY	Nymphoides_peltata
AJZ	Carpodetus_serratus
AKA	Stylidium_laricifolium
AKB	Apium_graveolens
AKC	Daucus_carota
AKD	Hedera_nepalensis
AKE	Panax_ginseng
AKF	Cornus_wilsoniana
AKG	Griselinia_littoralis
AKH	Alangium_chinense
AKI	Pittosporum_truncatum
AKJ	Sambucus_ebulus
AKK	Kolkwitzia_amabilis
AKL	Lonicera_japonica
AKM	Escallonia_macrantha
AKN	Polyosma_cambodiana
AKO	Brunia_albiflora
AKP	Columellia_oblonga
AKQ	Quintinia_verdonii
AKR	Actinidia_chinensis
AKS	Actinidia_eriantha
AKT	Actinidia_arguta
AKU	Impatiens_notolopha
AKV	Clethra_arborea
AKW	Clethra_alnifolia
AKX	Euclea_crispa
AKY	Diospyros_oleifera
AKZ	Diospyros_lotus
ALA	Vaccinium_corymbosum
ALB	Rhododendron_micranthum
ALC	Fouquieria_splendens
ALD	Fouquieria_diguetii
ALE	Napoleonaea_vogelii
ALF	Norantea_guianensis
ALG	Cleyera_japonica
ALH	Eurya_muricata
ALI	Gilia_yorkii
ALJ	Polemonium_pulcherrimum
ALK	Primula_vulgaris
ALL	Ardisia_escallonioides
ALM	Roridula_dentata
ALN	Roridula_gorgonias
ALO	Vitellaria_paradoxa
ALP	Chrysophyllum_cainito
ALQ	Synsepalum_dulcificum
ALR	Sarracenia_minor
ALS	Sinojackia_xylocarpa
ALT	Pterostyrax_corymbosus
ALU	Symplocos_cochinchinensis
ALW	Camellia_japonica
ALX	Camellia_sinensis
ALY	Curtisia_dentata
ALZ	Deutzia_floribunda
AMA	Hydrangea_macrophylla
AMB	Loasa_tricolor
AMC	Camptotheca_acuminata
AMD	Davidia_involucrata
AME	Aextoxicon_punctatum
AMF	Berberidopsis_corallina
AMG	Berberidopsis_beckleri
AMH	Dillenia_turbinata
AMI	Dillenia_indica
AMJ	Gunnera_manicata
AMK	Buxus_sinica
AML	Trochodendron_aralioides
AMM	Tetracentron_sinense
AMN	Nelumbo_nucifera
AMO	Platanus_acerifolia
AMP	Macadamia_ternifolia
AMQ	Grevillea_baueri
AMR	Macadamia_integrifolia
AMT	Meliosma_parviflora
AMU	Euptelea_pleiosperma
AMV	Akebia_trifoliata
AMW	Decaisnea_insignis
AMX	Kingdonia_uniflora
AMY	Cocculus_orbiculatus
AMZ	Menispermum_dauricum
ANA	Berberis_anhweiensis
ANB	Mahonia_bealei
ANC	Aquilegia_caerulea
AND	Coptis_chinensis
ANE	Papaver_somniferum
ANF	Eschscholzia_californica
ANG	Chloranthus_japonicus
ANH	Sarcandra_glabra
ANI	Chloranthus_spicatus
ANJ	Chloranthus_sessilifolius
ANK	Acorus_calamus
ANL	Acorus_gramineus
ANM	Acorus_americanus
ANN	Colocasia_esculenta
ANO	Colocasia_antiquorum
ANP	Alisma_plantago-aquatica
ANQ	Sagittaria_graminea
ANR	Potamogeton_wrightii
ANS	Pandanus_tectorius
ANT	Pandanus_utilis
ANU	Xerophyllum_tenax
ANV	Smilax_china
ANW	Lilium_brownii
ANX	Cymbidium_goeringii
ANY	Dendrobium_nobile
ANZ	Cymbidium_ensifolium
AOA	Iris_domestica
AOB	Allium_tuberosum
AOC	Allium_sativum
AOD	Yucca_filamentosa
AOE	Asparagus_officinalis
AOH	Trachycarpus_fortunei
AOI	Typha_latifolia
AOJ	Typha_orientalis
AOK	Ananas_comosus
AOL	Ananas_bracteatus
AOM	Juncus_effusus
AON	Juncus_setchuensis
AOO	Juncus_inflexus
AOP	Carex_scoparia
AOQ	Rhynchospora_pubera
AOR	Cyperus_serotinus
AOS	Sorghum_bicolor
AOT	Panicum_virgatum
AOU	Oryza_sativa
AOV	Setaria_italica
AOW	Zea_mays
AOX	Brachypodium_distachyon
AOY	Commelina_communis
AOZ	Eichhornia_crassipes
APA	Musa_acuminata
APB	Musa_nana
APC	Canna_indica
APD	Thalia_dealbata
APF	Dioscorea_oppositifolia
APG	Tacca_chantrieri
APH	Aristolochia_tagala
API	Aristolochia_contorta
APJ	Aristolochia_fimbriata
APK	Piper_sarmentosum
APL	Piper_nigrum
APM	Houttuynia_cordata
APN	Chimonanthus_salicifolius
APO	Chimonanthus_praecox
APP	Cinnamomum_camphora
APQ	Fissistigma_uonicum
APR	Annona_squamosa
APS	Liriodendron_chinense
APT	Magnolia_denudata
APU	Magnolia_biondii
APV	Horsfieldia_kingii
APW	Ceratophyllum_demersum
APX	Ceratophyllum_platyacanthum
APY	Illicium_verum
APZ	Illicium_henryi
AQA	Cabomba_caroliniana
AQB	Euryale_ferox
AQC	Nymphaea_colorata
AQD	Amborella_trichopoda
ZQD	Amborella_trichopoda
ATR	Amborella_trichopoda
GIN	Ginkgo_biloba
NCO	Nymphaea_colorata
TPL	Thuja_plicata 