AIA	Ceratophyllales_Ceratophyllales_Ceratophyllaceae_Ceratophyllum demersum
ABU	Chloranthales_Chloranthales_Chloranthaceae_Chloranthus sessilifolius
ABV	Chloranthales_Chloranthales_Chloranthaceae_Chloranthus spicatus
ADN	Eudicots_Asterales_Asteraceae_Helianthus annuus
AKQ	Eudicots_Asterales_Menyanthaceae_Nymphoides indica
AAS	Eudicots_Brassicales_Brassicaceae_Arabidopsis thaliana
AKA	Eudicots_Brassicales_Akaniaceae_Bretschneidera sinensis
AKL	Eudicots_Caryophyllales_Cactaceae_Hylocereus undatus
AKR	Eudicots_Caryophyllales_Simmondsiaceae_Simmondsia chinensis
AKG	Eudicots_Cornales_Nyssaceae_Camptotheca acuminata
ADL	Eudicots_Fabales_Fabaceae_Glycine max
AKI	Eudicots_Gentianales_Gentianaceae_Eustoma grandiflorum
AKB	Eudicots_Malvales_Dipterocarpaceae_Dipterocarpus turbinatus
AKC	Eudicots_Malvales_Dipterocarpaceae_Hopea hainanensis
AKD	Eudicots_Myrtales_Melastomataceae_Melastoma dodecandrum
AKF	Eudicots_Rosales_Urticaceae_Boehmeria nivea
AKH	Eudicots_Rosales_Elaeagnaceae_Elaeagnus angustifolia
AKK	Eudicots_Rosales_Elaeagnaceae_Hippophae rhamnoides
AKP	Eudicots_Santalales_Olacaceae_Malania oleifera
AKJ	Eudicots_Saxifragales_Hamamelidaceae_Hamamelis virginiana
AGG	Eudicots_Solanales_Solanaceae_Solanum lycopersicum
AHC	Eudicots_Vitales_Vitaceae_Vitis vinifera
ABE	Eudicots_Buxales_Buxaceae_Buxus sinica
AEG	Eudicots_Proteales_Proteaceae_Macadamia integrifolia
AIN	Eudicots_Proteales_Proteaceae_Telopea speciosissima
AZA	Eudicots_Proteales_Nelumbonaceae_Nelumbo nucifera
AAR	Eudicots_Ranunculales_Ranunculaceae_Aquilegia coerulea
ACY	Eudicots_Ranunculales_Berberidaceae_Epimedium pubescens
AIO	Eudicots_Trochodendrales_Trochodendraceae_Trochodendron aralioides
ABS	Magnoliids_Laurales_Calycanthaceae_Chimonanthus salicifolius
ABW	Magnoliids_Laurales_Lauraceae_Cinnamomum camphora
ABX	Magnoliids_Laurales_Lauraceae_Cinnamomum kanehirae
AIB	Magnoliids_Laurales_Lauraceae_Persea americana
AEH	Magnoliids_Magnoliales_Magnoliaceae_Magnolia biondii
AID	Magnoliids_Magnoliales_Magnoliaceae_Liriodendron chinense
AAU	Magnoliids_Piperales_Aristolochiaceae_Aristolochia fimbriata
AIC	Magnoliids_Piperales_Aristolochiaceae_Aristolochia contorta
AAE	Monocots_Acorales_Acoraceae_Acorus americanus
AKE	Monocots_Acorales_Acoraceae_Acorus gramineus
AHJ	Monocots_Alismatales_Araceae_Wolffia australiana
AHH	Monocots_Alismatales_Zosteraceae_Zostera marina
ABF	Monocots_Arecales_Arecaceae_Calamus simplicifolius
AFF	Monocots_Arecales_Arecaceae_Phoenix dactylifera
AAI	Monocots_Asparagales_Amaryllidaceae_Allium cepa
AAV	Monocots_Asparagales_Asparagaceae_Asparagus officinalis
ACP	Monocots_Asparagales_Orchidaceae_Cymbidium ensifolium
ADJ	Monocots_Asparagales_Orchidaceae_Gastrodia elata
AIJ	Monocots_Asparagales_Orchidaceae_Apostasia shenzhenica
ACT	Monocots_Dioscoreales_Dioscoreaceae_Dioscorea alata
ACU	Monocots_Dioscoreales_Dioscoreaceae_Dioscorea rotundata
AAB	Monocots_Pandanales_Velloziaceae_Acanthochlamys bracteata
AAN	Monocots_Poales_Bromeliaceae_Ananas bracteatus
AAO	Monocots_Poales_Bromeliaceae_Ananas comosus
AAH	Monocots_Poales_Poaceae_Aegilops tauschii
ABP	Monocots_Poales_Poaceae_Cenchrus purpureus
ABQ	Monocots_Poales_Poaceae_Chasmanthium laxum
ACC	Monocots_Poales_Poaceae_Cleistogenes songorica
ACG	Monocots_Poales_Poaceae_Coix lacryma-jobi
ACX	Monocots_Poales_Poaceae_Eleusine coracana
ADO	Monocots_Poales_Poaceae_Hordeum vulgare
AEB	Monocots_Poales_Poaceae_Leersia perrieri
AEO	Monocots_Poales_Poaceae_Miscanthus sinensis
AEX	Monocots_Poales_Poaceae_Oropetium thomaeum
AEY	Monocots_Poales_Poaceae_Oryza sativa
AFA	Monocots_Poales_Poaceae_Paspalum vaginatum
AFD	Monocots_Poales_Poaceae_Pharus latifolius
AFT	Monocots_Poales_Poaceae_Raddia distichophylla
AGD	Monocots_Poales_Poaceae_Secale cereale
AGJ	Monocots_Poales_Poaceae_Sorghum bicolor
AGK	Monocots_Poales_Poaceae_Streptochaeta angustifolia
AGW	Monocots_Poales_Poaceae_Urochloa fusca
AHE	Monocots_Poales_Poaceae_Zea mays
AHF	Monocots_Poales_Poaceae_Zizania latifolia
AIR	Monocots_Poales_Poaceae_Bonia amplexicaulis
AIS	Monocots_Poales_Poaceae_Olyra latifolia
AIT	Monocots_Poales_Poaceae_Phragmites australis
ADV	Monocots_Poales_Joinvilleaceae_Joinvillea ascendens
AKN	Monocots_Poales_Juncaceae_Juncus effusus
AKO	Monocots_Poales_Juncaceae_Juncus inflexus
AEQ	Monocots_Zingiberales_Musaceae_Musa acuminata
AIH	Monocots_Zingiberales_Zingiberaceae_Zingiber officinale
AKM	basal angiosperms_Austrobaileyales_Schisandraceae_Illicium verum
AEV	basal angiosperms_Nymphaeales_Nymphaeaceae_Nymphaea colorata
ADD	basal angiosperms_Nymphaeales_Nymphaeaceae_Euryale ferox
AAL	basal angiosperms_Amborellales_Amborellaceae_Amborella trichopoda
AZB	Outgroup_Cupressales_Cupressaceae_Thuja plicata
AHX	Outgroup_Gnetales_Gnetaceae_Gnetum montanum
ADK	Outgroup_Ginkgoales_Ginkgoaceae_Ginkgo biloba